//////////////////////(///////////////(////////////(((((((////((((((((((((((((((((((((((((((((((((((((((((((((((((((((////////////////////////////
///////(/////(////////////////////////***//***//*/**##/((((#*/////////(((////((//(((((//////////(((((((((((((((((((((((///////////////////////////
//////////////////////////////*/%#%(**%##(%/(###############((#**///////////**//(/*////*/*/*/**/////////*/***///////((((//////////////////////////
//////*(/(/////////////*(*%//***%*%((##***(/(((############(/#*////////////##*#****//////****//*//////////***/***////////*******//////////////////
**///***/(///////////%%**//////**,,*****/////***(########(///(*/////////////**////*/*///*/***/****/***//*****///*************************////////*
****//**##**//(/(/****/*#%##%***#%*#%%%%##**///**(#####((/((/*/*//*/////////*/*#/***/*/***/*/**///////////////**///****//*//////*//*/(**//*/***/**
******#(//(////##%#########%#%%%#%%%%%***/%#(**/*#####(((**((***//////////*#/((#(*//*//*///**/*////*////*************/***/**///*//**********/*****
******/(#/(**//((((((##%%#####%%##(*%**#**(/(////*(#/#*////***(****////**#/((*###(//////////*///////////**********/////***,,*,,**,*,**********(/**
//**/**(#(**(///##((*#####%%%####******%%#%*#*//(//////////////*//******(//(#**,*,///////*//*///////////****************/**,/****/*/**/*///******/
////**(*(((//(////*#((/((((####%%%%%%%*%#######**////////////////*/*%*******((#%((/**/*////**//((/*///****,********,****,*/**///**,*((*(//*////*//
((((((((((((((//////%%((((((#(#%#####%%####%*(/%#*///(((/////((((****//#,.(/#/###%%##*/*(((///(///**///,..*....,,,.(/((*******//(*((((/(((((((((((
(((((((((((((((((////(*//**////(/((((*(%(/#(%******/((((/////((/((/(/*,*/(*#/(%(#*#/**//*(((#/(//////(((//.......///(##/*,**#*/(((((((((((((((((((
(((((((((#(#(((((///(*(/*/***,//((###(/(////((((((##((((//*(((((/*.(/**/*((*/%#/*///*/*/#*%%%%(/./*//////#((#/////(#**(////*#((((((((((*(#(#((((((
((((((((((((((((((((((**/(/**//(##(#(((*/((((((((((((//////((((/(//,,(###(*//////(,(,/,......(/(/((,,,,,,,,,**///###***,(#**(((((((/(((((/*(((((((
(/((((((((((((((((((((#(/,*,..,#***/*,(*((((((((((((//((((((((////(###(##.,,,,,#((/,*,****.,..(#%##%%,**/(#**///*##/****//(/((((((((((((((((((((((
(((((((/*((((((((((((/(/////*..,(***/#/%(/*((((((((//(((((((((**(((//(##(/(,*,./((#(*,*/#*/(#///###(####*/#///*#(*,*/(((((((//(((((((((((/*(((((((
(((((((((((((((((((((((////////((/((((/(((/((*((((//((((((((//*##((///(((((*((//(/((,*(((#////////##%//((/*/%%*///(/#((((((((/((/((((((((((((((/((
(((((((((((((((((((((((((////(//////((///###%#**/((((//(((((((/*#*.,/###*(#,*//,//,,/*(((/(//((((//#*##//*/***/*/#///**((((//////(((((/(((((((((((
(((((((#/##((((((((((((((////////////(/(*//((*((***/((((///(((((((((((((((//*****//((##*(((((//////(((((/(*.*(*/*/,*((*(/(((/((((//((((*//((((((((
(((((((((/((((((((((((((((////////////#(#%#////////*/*//*#(((((////((((((,.****,,*(((/((((///(////(((/((((((*.,******(****.,((((*//(#(//((#((/((((
(//(((/(((((((((/((((/(/(////(((//(((((%/#*/************(((((((///((((((((*///*,//,(#/(//(((/*///(((((((((((((((((((*,*********#*//((/(((/((/(((((
((((((((((/(((/(/((//////////(//(((((((/(**.,,,/*******((((((((///(((((((*////**(***/(*,,(((*////((((((/((((((((////*#(###%#%(**((///((///(///((((
(((((((#(((((((##/////#/(#(%///(((((//((((#,((%%*,**/*/((((((#(#/#(((((/(*,//*/*((//((,./(((((///#/((((/(((((((*//#((###(((%####*//////##(##/(((((
(((((((((((((((((((////////////////////(((//####**/*///////(((/////(((/(((/*((//,#*/((//((((/((((////((/////(((((*####(########%((////(///((((((((
((((((((((((((((((////(/////////////////(//((##*/*(((((((/(///////(/((((((((****((/(((//////((((((///////(((((((//%(*((//**(/%/,(((/////**/(((((((
((((((((((((((((((((((((//////((////(/((/(/(##**/(((((((((((/////(//(((((((/(((//((((/////((((((((//(//////(/((((((((((((((((**((((((/**/(//((((((
(((((((((((((((((((((((////////((((/////*/((,*/((((((((((((((///////(((((((((((((((/////*//((((//////////////////(((((((((((((/(((((((*(/////(((((
(((((((((((((((((((((////////(((((((((//*((*****//////(((((/(/(///////////(/((((((((((((((((((*(*/(///((//////////////////////(/((((((****((((((((
((((((((((((/////((/////////((((((((((((((/*/(///((/////((((#(((//////(/(//////(((((///((/((((((////(((((((//////((((((((/////(/(((((/**((((((((((